95
61 60 61 63 66 69 70 69 66 62 61 61 63 67 72 74 74 71 67 65 65 66 69 71 73 73 71 70 69 68
59 59 60 62 65 68 69 68 65 62 61 61 64 67 71 73 72 70 67 65 66 67 69 71 73 74 74 74 75 75
56 56 58 60 63 66 67 67 65 62 61 62 65 68 71 72 70 67 65 65 66 68 69 71 73 75 77 80 83 85
53 54 56 59 62 65 67 67 65 62 62 64 67 70 72 71 69 66 65 65 67 68 69 71 72 75 79 84 89 92
51 52 55 59 62 66 67 67 65 63 63 65 69 73 74 72 69 66 64 65 67 68 69 70 72 75 79 85 91 95
51 52 56 60 64 68 70 69 66 64 64 67 71 75 76 74 70 67 65 66 67 69 70 71 72 74 77 82 88 92
51 54 58 63 68 72 73 71 68 66 66 69 73 77 78 76 73 70 68 68 69 70 71 72 72 73 75 78 83 86
53 55 60 66 71 75 76 73 70 67 67 70 74 78 80 79 76 73 71 70 71 71 72 72 73 73 74 76 78 79
56 59 64 69 74 77 77 74 70 68 68 71 76 80 82 82 80 77 75 73 73 72 72 71 72 72 73 73 73 73
60 62 67 72 76 78 77 73 69 67 67 71 77 82 85 85 83 80 78 76 74 72 70 69 69 70 71 71 69 67
62 64 68 72 76 77 75 71 66 65 66 71 77 83 86 87 85 82 79 76 74 72 70 68 68 68 69 67 64 62
63 65 68 71 74 75 72 68 64 62 65 70 77 83 87 88 86 83 79 76 74 72 69 67 66 66 65 63 60 57
65 66 68 71 73 73 70 66 62 61 63 68 75 82 86 88 86 82 77 74 72 71 70 68 66 65 63 60 57 54
67 68 70 72 73 73 70 66 62 61 62 66 73 80 85 87 86 81 76 73 72 71 70 68 66 64 62 60 57 55
69 70 72 74 76 75 72 68 64 62 63 66 71 78 84 87 85 81 76 73 72 71 69 67 65 64 63 62 60 58
72 73 75 78 79 78 74 70 67 65 64 66 70 76 82 85 84 81 77 74 72 70 67 65 63 64 64 64 64 63
76 77 79 81 82 81 78 74 70 68 67 67 69 74 79 82 83 81 78 75 73 69 65 62 61 62 65 67 68 69
81 81 83 85 86 85 81 77 74 72 69 68 69 72 76 79 80 79 77 75 73 69 65 61 60 62 66 70 73 75
85 86 87 89 89 88 85 81 78 75 72 70 69 71 74 76 76 75 74 73 72 70 67 63 62 64 67 71 76 79
88 88 90 91 91 90 87 84 80 77 75 73 72 72 73 73 72 69 68 69 70 71 70 69 67 67 69 72 77 80
87 88 89 90 90 90 88 85 82 79 77 75 74 74 74 72 68 64 63 64 68 72 74 75 74 72 71 72 75 77
84 85 85 86 86 87 86 84 81 79 78 77 77 76 74 71 66 62 60 62 67 72 77 79 79 76 73 71 72 74
80 80 80 80 81 81 81 80 78 78 78 79 79 78 75 71 67 62 61 62 67 73 78 82 82 79 74 70 69 70
76 76 75 75 76 77 77 76 75 76 78 80 81 79 77 73 69 66 64 65 68 72 77 82 83 80 74 69 66 66
76 75 74 73 74 74 73 72 71 73 77 80 81 80 78 76 73 71 69 68 69 71 75 80 81 79 73 67 64 63
78 76 75 74 74 74 72 69 67 69 73 76 78 78 78 77 75 74 72 70 69 70 73 76 77 75 71 66 62 61
81 79 77 76 76 75 72 68 65 65 68 71 73 75 75 76 76 75 73 70 68 67 68 71 72 71 68 65 62 61
85 82 79 77 76 74 71 67 63 61 62 65 67 69 71 72 73 73 72 70 67 64 63 64 65 66 65 64 63 62
88 85 80 77 75 73 70 65 61 59 58 59 61 63 66 69 70 70 70 68 64 61 58 58 60 61 63 64 64 64
90 86 80 76 74 72 69 65 60 57 55 55 56 60 63 66 68 69 69 67 63 58 55 54 56 59 62 64 64 65
