89
39 43 49 55 60 63 65 64 62 61 63 68 72 75 76 76 73 69 65 64 65 67 71 74 76 78 78 80 81 83
41 45 51 58 62 65 66 64 61 61 63 67 71 75 76 76 73 70 66 64 65 67 70 73 75 76 76 76 77 78
45 49 56 62 66 67 66 63 60 60 62 66 71 74 76 77 75 72 68 66 65 66 69 72 74 74 72 70 70 70
51 56 62 67 68 67 64 61 58 59 62 67 71 74 76 77 77 75 72 68 66 66 68 70 71 70 67 63 61 60
59 63 67 70 69 66 61 58 57 58 63 68 71 74 76 78 79 78 76 72 69 67 68 69 69 67 63 59 56 54
66 69 71 71 68 63 59 55 55 58 63 68 72 73 75 77 80 81 80 77 73 71 69 69 68 66 62 57 54 53
70 71 72 71 67 61 57 55 55 58 63 68 71 72 74 77 80 83 83 82 79 76 73 71 69 66 63 59 56 55
69 69 70 68 65 61 58 56 57 60 64 67 69 70 72 75 79 82 84 85 83 81 78 74 71 68 66 63 60 59
63 64 65 65 63 61 60 60 61 63 65 67 68 69 71 73 76 79 82 84 86 85 83 79 75 72 69 67 64 62
58 59 61 62 62 62 63 65 67 69 69 69 69 69 69 70 71 73 77 81 84 86 86 83 79 76 73 70 68 66
57 59 61 63 63 64 66 69 72 73 73 72 70 69 68 67 67 67 70 74 80 84 86 85 82 79 76 73 71 69
60 62 65 66 67 68 69 73 75 77 76 73 71 69 68 66 64 64 65 69 74 80 83 84 82 79 77 75 73 73
67 68 71 72 73 73 74 76 78 78 76 73 71 69 68 66 64 62 62 65 69 74 78 80 79 77 75 75 75 76
74 75 77 78 79 78 78 79 79 78 75 72 71 70 69 67 65 63 62 63 66 69 73 75 75 73 72 73 75 77
77 79 81 83 83 83 82 82 81 78 75 71 70 70 70 69 67 64 63 63 64 65 67 69 69 68 68 69 72 74
77 80 83 84 85 84 84 83 82 78 74 71 70 70 71 71 69 67 65 65 64 65 65 66 65 64 64 65 67 69
75 78 81 83 83 84 84 84 83 79 74 71 70 71 72 72 70 69 67 67 67 66 66 65 63 62 60 60 62 63
71 73 77 79 81 82 84 85 84 81 76 72 71 71 72 72 71 70 69 69 70 70 68 67 64 61 58 58 58 59
67 70 73 76 79 81 84 86 85 82 77 73 71 71 72 72 72 71 71 72 73 74 73 70 66 62 59 57 57 58
65 68 71 75 78 82 86 87 86 82 78 74 72 71 72 72 72 72 73 75 77 78 77 74 69 64 60 58 58 59
67 69 72 76 80 84 87 88 85 81 77 74 72 71 71 71 71 72 75 79 82 83 81 77 72 66 61 59 59 59
69 71 74 78 82 85 87 87 84 79 76 73 72 71 70 69 70 72 77 83 86 87 84 79 74 68 63 60 60 60
74 75 78 81 84 86 87 85 82 78 74 73 72 70 68 67 69 72 78 84 88 89 85 80 74 69 64 61 60 60
77 78 80 83 84 85 85 82 79 76 73 72 71 69 67 66 67 72 77 83 87 87 84 79 74 70 66 63 61 61
80 81 82 84 84 84 82 80 77 74 73 72 70 68 66 65 67 71 76 80 83 83 80 77 74 71 68 65 63 62
82 83 83 84 84 83 80 77 75 73 73 71 69 67 65 65 68 71 75 77 78 78 76 74 73 72 70 68 66 64
81 82 82 83 83 82 79 76 74 74 73 72 69 67 66 67 70 73 76 76 76 74 73 72 72 73 72 71 69 67
77 79 80 82 83 82 80 77 76 75 75 73 70 67 67 68 72 76 78 78 76 74 72 72 73 74 74 74 72 70
72 74 77 81 83 83 81 79 77 77 76 73 70 68 67 70 74 78 80 80 77 74 73 73 74 75 76 75 73 72
68 70 75 80 83 84 83 80 79 78 77 74 70 68 67 70 75 79 81 81 78 74 73 73 74 76 76 75 73 71
