92
78 76 76 77 80 82 82 79 76 74 72 71 70 70 70 70 71 72 73 75 78 82 87 90 91 90 87 83 79 76
77 75 74 75 78 79 78 76 73 70 69 68 69 70 71 72 72 72 73 74 77 82 86 88 89 88 87 84 80 78
76 74 72 72 73 74 73 71 68 65 64 65 68 70 73 74 74 73 73 74 77 80 83 85 86 86 86 84 81 79
75 73 70 69 69 69 69 67 64 62 62 64 67 71 74 75 75 74 74 75 77 79 80 81 82 83 84 83 81 79
75 73 70 67 66 65 65 64 64 63 63 65 68 72 75 76 76 76 77 78 79 78 78 77 79 80 81 80 78 77
74 72 70 66 64 62 62 64 65 66 67 68 71 74 76 77 77 78 80 82 81 78 74 73 74 76 77 76 73 71
72 71 69 65 61 59 60 63 67 70 72 73 74 75 77 77 79 81 84 85 82 77 72 69 70 72 73 71 68 65
70 69 67 63 60 58 59 62 68 72 76 77 78 78 78 79 81 83 86 86 83 77 70 67 66 68 69 67 64 61
68 67 65 62 59 57 59 63 69 74 78 81 81 81 80 81 82 85 87 86 83 76 70 66 65 66 66 65 64 62
67 66 64 62 60 60 62 66 71 76 80 83 83 82 80 80 81 84 85 84 81 76 71 67 66 66 66 67 66 66
68 67 66 65 64 65 67 71 75 79 82 83 83 81 79 78 79 81 82 82 79 76 73 70 68 68 68 69 69 69
70 69 68 68 69 70 73 76 79 82 83 83 81 78 76 75 76 77 79 78 77 76 74 73 71 71 70 70 71 71
73 72 71 71 72 74 76 78 81 83 83 81 78 75 72 71 72 74 76 76 76 76 75 75 74 73 72 71 71 70
77 76 75 74 74 75 77 78 80 81 80 78 75 71 69 68 70 72 74 75 76 76 76 75 74 73 72 71 70 69
84 82 80 77 76 76 76 77 77 77 76 74 72 70 68 68 70 73 76 78 78 78 77 76 75 74 74 73 72 71
89 88 84 81 78 77 76 76 75 74 72 70 69 69 69 69 71 74 77 80 80 79 77 76 76 76 77 76 75 74
92 90 87 83 80 78 76 75 73 71 68 67 68 69 70 71 74 76 79 81 81 79 77 76 77 79 80 79 77 75
90 88 86 83 80 77 75 74 71 67 65 64 66 68 70 73 75 77 79 80 80 78 76 76 78 81 82 80 76 74
85 84 83 81 79 76 74 71 68 64 62 62 64 67 70 72 74 76 78 79 78 76 75 76 79 81 81 78 74 71
81 81 81 80 78 75 72 69 65 62 60 60 63 65 68 70 73 75 77 78 77 75 74 75 77 79 78 75 71 68
79 79 79 79 77 75 72 68 64 61 60 61 62 64 65 67 69 73 75 76 76 74 72 72 73 75 75 72 69 67
79 79 78 78 76 75 73 70 66 64 62 63 63 63 63 64 66 70 73 75 74 72 69 68 69 71 72 71 70 70
78 77 76 75 74 74 74 73 71 68 67 66 65 64 62 62 64 67 70 72 73 71 68 66 67 69 71 73 74 75
75 74 72 71 72 73 75 76 76 74 72 71 69 67 64 62 62 64 67 70 72 71 68 67 68 71 74 76 79 80
72 71 69 69 70 73 76 79 79 78 75 73 71 69 66 64 63 63 66 69 72 73 72 71 72 74 77 80 82 84
71 70 69 69 70 73 76 78 79 78 76 74 72 70 68 65 64 63 66 70 74 77 78 77 77 77 79 80 82 83
70 70 70 70 71 73 74 75 76 76 75 73 70 69 67 65 64 64 66 71 76 80 81 80 78 77 77 77 77 77
71 71 72 74 74 73 72 71 72 72 72 69 67 64 63 63 63 64 66 70 76 80 81 79 75 72 71 70 69 69
72 74 76 78 77 74 70 68 68 69 69 66 62 60 59 60 61 63 65 69 75 78 79 75 70 66 63 62 61 61
74 76 79 80 79 74 69 65 65 67 67 64 60 56 56 57 59 61 64 68 73 77 76 72 67 62 59 57 56 56
