92
51 56 63 71 77 80 80 78 76 76 76 76 75 72 70 69 71 73 74 71 68 65 65 68 74 80 84 85 84 83
55 59 65 71 76 79 79 77 75 75 75 75 73 71 70 69 71 72 72 69 67 65 65 68 73 78 81 81 80 78
61 64 68 72 76 78 78 76 75 74 73 73 72 71 70 70 70 70 69 67 65 64 65 68 72 75 76 75 74 73
67 69 72 75 77 78 78 77 76 75 74 73 72 72 72 71 70 69 67 65 63 63 65 69 71 72 72 70 69 69
72 74 76 77 78 78 78 79 79 78 76 74 73 73 74 73 72 69 66 63 62 63 66 70 72 72 70 69 68 68
77 78 80 81 81 81 81 82 82 80 78 75 74 75 76 76 74 71 66 63 62 63 67 71 74 73 71 70 70 71
82 83 84 85 85 84 84 84 83 81 77 74 74 75 76 77 75 72 68 64 62 64 69 73 76 75 74 73 73 74
87 87 88 89 88 87 85 84 82 78 75 72 72 73 75 77 76 74 70 66 65 66 70 75 77 78 77 75 75 75
88 88 90 90 89 87 84 81 78 74 71 69 69 71 73 75 76 75 73 70 69 70 73 77 79 80 78 77 75 75
84 85 87 88 87 84 81 78 74 71 69 68 68 69 71 73 75 76 75 74 73 74 75 78 80 81 79 77 75 74
77 78 80 81 81 79 76 73 71 69 68 67 68 68 69 71 74 76 77 77 77 76 77 78 80 80 79 77 74 73
70 71 72 72 72 72 71 70 69 69 68 68 69 69 70 71 73 76 78 78 78 77 76 77 77 78 77 76 74 73
66 66 65 65 66 67 67 68 69 70 70 71 72 72 72 73 74 76 78 79 77 75 73 72 73 73 74 74 73 73
66 65 64 64 64 65 67 69 71 72 73 73 75 75 76 76 77 78 79 78 76 73 70 68 68 69 70 71 71 71
68 68 67 67 67 68 69 71 73 74 75 76 77 78 79 80 80 80 79 77 74 70 67 65 64 65 66 67 68 69
73 73 73 74 74 74 73 74 75 75 76 76 77 78 80 81 81 80 78 75 71 68 65 63 63 63 63 64 65 66
78 79 80 81 81 79 77 76 76 75 75 75 75 76 78 79 80 78 75 72 69 66 65 64 64 63 63 64 66 67
84 85 85 86 85 83 80 77 75 74 73 72 72 73 75 76 76 74 72 69 68 67 67 67 67 67 66 67 69 71
88 88 88 87 86 84 81 78 75 73 71 71 70 70 71 72 71 69 67 66 67 68 70 71 71 70 70 71 74 76
90 89 87 86 85 84 81 78 74 72 71 71 70 69 69 69 68 66 64 64 66 69 71 73 72 72 72 74 77 80
90 88 85 83 82 82 80 77 73 72 72 73 72 71 70 69 67 65 63 63 65 68 70 72 71 71 71 74 78 81
89 86 82 79 79 79 78 75 73 73 74 76 77 76 74 72 69 65 62 61 62 65 68 68 68 68 69 72 77 80
88 85 80 76 75 75 74 72 71 72 76 79 81 80 78 75 70 64 60 58 59 62 64 66 66 66 67 70 74 77
86 83 78 74 72 72 72 71 70 73 77 81 83 83 81 77 71 64 58 56 56 59 62 65 66 67 67 68 71 73
84 81 77 73 71 71 71 70 71 73 77 81 84 84 83 78 71 64 58 55 56 59 63 66 68 69 68 68 68 69
82 79 76 73 71 71 71 71 72 74 77 81 84 85 84 81 74 67 62 59 60 63 66 69 71 72 71 69 68 67
81 79 76 73 71 71 72 73 74 75 77 80 83 85 85 83 79 73 68 66 66 67 69 71 72 73 73 70 68 67
84 82 78 74 71 71 73 75 76 76 78 80 82 85 86 86 84 80 77 75 73 71 70 71 72 73 73 72 70 68
88 86 81 75 72 71 73 75 77 77 78 79 81 84 87 88 88 86 84 81 78 75 72 70 71 72 73 72 71 69
92 89 83 77 72 71 73 75 76 77 77 78 80 83 87 89 90 89 88 85 82 77 73 70 70 71 72 73 72 71
