93, 93, 93
85 82 79 76 75 75 76 74 71 68 67 68 71 74 77 78 76 76 76 78 80 81 81 80 78 77 78 80 84 87
87 85 82 79 78 79 78 76 73 69 68 69 72 75 77 77 76 75 76 78 79 79 78 77 77 76 76 78 82 84
90 88 86 84 83 83 81 78 74 71 70 71 74 76 77 76 75 75 75 76 76 74 73 73 73 73 74 75 78 80
92 92 90 89 87 85 82 78 74 71 71 73 76 77 77 75 74 74 74 73 71 69 67 67 69 70 71 72 74 75
93 93 92 91 88 85 82 77 72 70 71 73 76 77 76 74 73 73 73 71 68 64 63 63 66 67 68 69 70 71
93 92 91 89 86 83 79 74 71 69 70 73 76 76 75 74 73 74 73 70 66 62 60 61 64 66 67 67 67 67
91 90 88 86 83 80 77 74 71 69 70 72 74 75 74 74 75 75 74 70 65 62 60 61 63 65 67 67 67 66
90 88 85 82 79 78 77 76 74 72 71 71 72 73 73 74 75 76 74 71 66 62 60 61 63 66 68 69 68 68
90 87 83 79 78 78 79 79 78 76 74 73 72 72 72 73 75 75 74 71 68 65 63 62 64 68 71 73 72 71
90 87 82 78 77 78 80 82 82 80 78 76 73 72 71 72 73 74 74 72 71 69 67 65 66 70 73 76 76 75
90 87 82 78 77 78 81 83 84 83 81 78 75 73 72 71 72 74 74 75 75 74 71 69 69 71 74 76 77 77
89 86 81 77 76 78 81 83 85 85 82 79 76 74 72 71 71 72 74 76 78 78 76 73 71 71 73 75 76 76
85 83 79 76 75 77 80 83 85 84 82 78 76 74 72 71 70 71 74 77 80 81 79 76 72 70 71 72 73 74
83 81 78 76 75 76 80 82 83 82 79 76 74 73 72 70 69 69 71 75 80 82 81 77 73 70 69 69 70 71
82 81 78 76 76 77 80 81 81 78 75 73 72 73 72 71 68 67 69 73 78 81 81 77 73 69 68 68 69 70
83 82 80 79 78 79 80 79 77 74 71 70 70 72 72 70 68 66 67 70 75 79 79 76 73 70 69 68 69 69
85 84 83 81 81 80 78 76 73 69 67 67 68 71 71 70 68 66 66 69 73 76 76 75 72 71 70 70 70 70
86 85 84 83 82 80 77 73 69 66 65 65 67 69 71 71 70 68 68 70 72 74 75 74 72 71 72 72 72 73
84 84 84 84 82 79 74 70 67 65 64 64 65 68 71 72 72 72 71 72 73 74 74 72 71 71 72 74 76 77
81 81 82 82 81 77 72 68 65 64 64 64 65 67 71 74 75 76 76 76 76 75 74 72 70 70 72 75 79 81
77 78 80 80 79 75 71 67 66 66 66 66 66 68 72 76 79 80 81 80 79 77 75 71 69 68 71 75 80 83
75 76 78 79 78 75 71 68 68 69 70 70 70 71 74 78 82 84 84 83 82 79 76 71 68 67 69 73 79 83
74 76 78 79 78 75 72 70 71 73 74 75 74 74 77 81 85 86 86 84 83 80 77 72 67 65 67 71 76 80
75 77 78 79 78 75 72 71 73 76 78 78 77 77 79 83 86 87 86 84 82 81 77 72 67 64 65 68 73 76
76 77 78 78 76 74 72 71 74 77 79 79 78 78 80 83 86 87 85 83 82 81 79 74 68 64 63 66 69 72
74 74 75 75 73 71 70 71 73 76 78 78 77 76 78 80 83 84 83 82 82 82 80 76 70 65 63 64 66 68
69 70 70 70 69 69 70 71 74 77 79 79 77 75 75 76 77 79 80 81 82 83 82 79 73 67 64 62 63 64
66 66 66 66 67 68 70 72 75 78 80 80 78 74 72 71 71 73 75 78 80 83 83 80 75 69 64 60 59 59
65 65 65 65 66 68 71 74 77 80 82 82 79 75 71 68 66 67 70 74 78 81 82 80 76 69 63 58 55 53
65 65 65 65 67 69 72 75 78 81 83 83 81 76 71 66 64 64 67 71 76 80 82 80 75 68 61 55 51 49
