88, 88, 88
74 75 75 74 70 66 64 63 64 65 66 68 71 74 75 75 73 70 69 70 74 78 80 80 78 76 77 78 79 80
75 75 76 74 71 67 64 63 63 64 65 67 69 72 75 75 73 71 69 70 73 77 78 78 76 75 74 75 75 76
77 77 77 75 72 68 64 63 63 63 63 64 67 70 73 75 73 71 70 70 72 75 76 75 74 73 72 71 71 72
78 78 78 76 73 69 65 64 64 64 63 63 65 68 71 73 72 71 69 70 71 73 73 73 72 71 69 69 68 69
78 78 78 77 74 70 67 66 66 66 65 64 65 67 69 71 71 70 69 70 71 72 72 71 70 69 68 68 67 68
76 77 77 76 73 70 68 68 68 69 68 67 66 67 68 69 70 70 69 69 70 71 71 70 69 68 68 67 68 68
73 74 74 73 71 69 69 70 72 72 71 70 68 68 68 70 71 71 70 69 69 69 68 68 67 67 67 68 69 69
68 69 69 70 70 70 72 74 76 76 74 72 70 69 69 70 71 71 70 68 67 66 65 65 65 65 67 68 70 70
65 66 67 68 70 72 76 79 80 79 75 72 70 69 69 70 71 71 70 67 64 62 60 60 61 63 66 69 72 73
65 66 68 70 73 77 81 84 84 81 76 71 68 67 68 69 70 70 68 65 61 58 56 57 59 62 67 71 75 77
69 70 72 74 77 81 85 88 87 82 76 71 67 66 66 67 68 68 66 63 59 56 55 55 58 63 68 73 77 80
76 76 77 79 81 84 87 88 86 82 76 71 68 67 66 67 67 66 64 61 58 56 55 57 60 65 69 74 79 82
81 81 81 81 82 84 85 85 83 80 75 72 69 68 68 68 68 66 64 61 59 58 59 61 65 68 71 75 78 81
84 84 82 82 81 82 82 82 80 77 74 72 71 71 71 71 70 68 66 64 63 63 64 67 69 71 73 74 76 78
82 81 80 79 79 79 79 78 76 74 73 72 72 73 73 74 73 71 69 68 67 68 69 71 72 72 72 72 72 73
77 76 75 75 76 77 77 76 74 73 73 73 74 75 76 76 76 74 73 72 72 72 72 72 72 71 69 69 69 70
73 72 72 73 74 76 76 75 74 74 74 75 76 76 77 77 77 77 76 76 75 74 73 72 70 68 67 68 69 70
73 73 73 74 76 77 77 76 76 76 77 77 77 76 76 77 77 78 78 78 77 75 73 70 68 66 67 69 72 74
78 78 78 78 78 78 78 77 77 77 77 76 75 73 73 74 76 78 79 79 77 75 73 70 68 67 68 72 76 79
85 84 83 82 81 79 78 77 76 75 74 73 70 69 69 71 74 78 80 80 78 76 74 71 68 67 70 74 78 80
88 87 86 84 82 79 77 74 72 71 69 67 65 63 64 67 72 77 80 81 80 77 75 71 68 67 68 72 75 77
86 86 85 83 81 78 74 71 69 67 65 63 61 60 61 64 70 76 80 81 80 78 75 71 67 65 66 68 71 72
81 82 81 81 79 76 73 70 68 66 64 62 59 58 59 62 68 74 79 80 79 77 74 70 66 63 63 64 67 68
79 80 80 79 78 77 74 71 69 67 65 63 61 60 60 62 66 72 77 78 77 75 72 69 66 63 61 62 64 66
81 81 81 80 79 78 76 74 71 69 67 66 65 63 62 63 66 70 74 75 74 72 70 69 67 64 61 62 64 66
84 84 83 82 80 79 77 75 73 71 69 69 69 68 66 66 66 68 70 71 71 71 71 71 70 67 64 63 64 66
87 86 85 83 81 79 76 74 72 70 70 71 72 72 70 68 67 67 68 68 70 71 73 73 72 69 65 64 65 66
86 85 84 82 80 77 75 72 70 69 69 71 73 74 72 70 67 65 65 67 69 72 75 75 73 70 66 64 64 65
83 82 81 80 78 76 73 70 68 67 68 70 73 74 73 70 66 63 63 66 70 75 77 76 73 69 66 64 63 63
81 80 79 78 77 75 72 68 66 65 66 69 72 74 73 70 66 62 62 66 71 76 78 76 72 68 64 63 62 62
