98
75 76 80 85 89 89 84 77 70 68 71 74 76 76 76 77 78 78 76 74 74 75 76 76 76 75 76 78 81 82
78 78 81 84 87 86 81 74 69 67 70 73 75 75 76 78 79 79 77 75 74 75 76 77 78 78 79 81 83 85
82 82 82 83 83 81 76 71 67 66 68 71 73 74 76 78 80 80 78 75 74 75 77 79 80 81 83 85 87 88
88 86 84 81 79 75 72 68 66 66 67 69 71 73 75 78 80 80 78 75 73 74 76 79 81 83 85 87 89 90
93 90 85 80 75 71 68 66 66 66 67 68 70 71 74 76 78 79 77 75 73 73 76 79 81 83 85 87 89 91
96 92 86 79 73 68 66 65 66 66 68 69 69 70 71 73 75 76 75 74 72 73 75 78 80 82 83 85 87 88
98 93 85 77 71 66 64 64 65 67 69 70 70 69 68 69 70 72 73 72 72 74 76 78 79 79 80 82 83 84
97 92 84 76 70 65 63 63 64 67 70 72 71 68 66 66 67 69 71 72 74 76 78 78 78 77 77 78 78 78
95 90 83 75 70 66 63 63 64 67 70 72 71 68 65 64 65 68 71 74 76 79 81 80 78 75 75 75 74 73
90 86 80 74 70 68 66 65 66 68 70 71 70 68 65 64 65 68 73 77 80 83 84 82 79 76 75 74 73 72
83 80 76 73 71 70 69 68 68 69 69 70 69 68 67 66 67 70 75 80 83 85 85 83 80 78 77 76 75 74
74 72 70 69 70 71 72 72 71 70 69 68 69 69 69 68 69 72 77 82 84 85 85 83 81 79 79 79 78 78
65 64 64 65 68 72 74 75 74 71 68 67 68 69 69 69 70 73 77 81 82 82 81 80 80 80 81 81 82 82
59 59 60 64 68 72 75 76 75 72 68 66 67 68 69 69 70 72 76 78 79 77 77 77 79 80 82 83 85 86
55 57 60 64 69 72 75 76 74 71 67 65 66 67 67 67 68 70 73 75 74 73 72 73 77 80 83 85 87 88
54 57 61 66 70 73 74 75 74 71 68 66 66 67 66 66 66 68 70 72 71 69 69 71 75 80 83 86 88 89
57 59 64 67 70 72 72 73 73 72 70 69 68 68 67 66 65 67 69 69 69 67 67 69 73 79 82 85 86 87
61 63 66 69 70 71 71 72 73 74 73 72 71 70 69 67 67 67 68 68 67 66 66 68 73 77 81 82 82 81
65 66 68 69 69 70 71 73 74 75 75 74 74 73 71 70 69 69 68 68 67 66 67 69 73 77 78 78 76 74
68 69 69 69 69 70 72 74 76 76 77 77 77 76 74 72 71 70 69 68 67 67 68 70 73 75 75 72 68 66
70 70 69 69 69 71 74 76 77 77 78 78 79 78 77 75 73 72 70 69 69 70 71 72 73 73 70 66 61 57
71 70 70 70 71 73 76 78 78 77 77 78 80 80 79 77 75 74 73 72 72 73 73 73 72 70 67 62 56 52
73 72 72 72 73 76 79 79 77 75 75 77 78 79 78 77 77 77 77 77 77 76 76 74 73 70 66 61 56 52
76 75 75 76 78 80 80 79 76 73 72 73 74 75 75 76 77 79 80 80 80 79 78 76 74 72 69 65 61 58
79 79 79 80 82 82 82 78 74 70 69 69 70 70 71 73 76 80 81 82 81 80 79 78 77 77 75 72 69 67
82 82 82 83 83 83 80 76 72 69 67 67 67 67 68 71 74 78 80 80 79 78 79 79 80 80 80 79 77 75
83 83 83 82 81 79 76 73 69 67 66 66 66 66 67 69 72 75 76 75 75 76 78 80 82 83 83 82 81 80
84 83 81 79 76 73 70 68 67 67 66 66 65 65 66 67 70 71 71 70 70 72 76 80 83 84 83 81 80 80
84 83 80 76 71 67 65 64 65 67 67 67 66 65 65 66 67 67 66 65 66 69 75 80 83 83 80 78 76 75
85 83 79 74 68 64 62 62 65 67 68 68 66 65 64 65 66 65 64 62 63 67 74 80 83 82 78 74 72 71
