91
74 74 73 71 70 70 70 71 71 73 77 81 84 86 85 82 77 72 67 64 62 62 63 64 67 70 73 74 74 74
73 73 73 72 71 71 71 71 72 74 77 80 82 83 82 79 75 71 68 65 65 65 65 67 69 72 75 76 76 77
73 73 73 73 73 73 73 73 73 75 77 79 80 79 77 74 72 69 68 68 68 69 70 71 73 75 77 78 79 79
73 74 75 75 75 75 76 76 76 76 77 77 76 74 71 69 68 68 69 70 72 73 73 74 75 76 78 79 79 80
74 75 76 76 77 77 78 79 79 78 77 75 72 69 66 65 65 66 69 72 74 75 75 75 75 76 77 78 78 78
73 74 75 75 76 77 79 80 80 79 76 73 70 67 65 64 64 66 69 72 75 76 75 75 75 75 76 76 76 75
73 73 73 73 74 76 78 79 79 77 74 71 69 67 66 66 65 66 68 72 75 76 76 75 75 76 77 77 76 75
73 73 72 71 71 73 74 75 75 74 72 70 70 70 70 69 68 67 68 71 74 76 77 77 77 79 80 80 79 78
75 74 72 71 70 69 69 70 70 70 70 71 72 74 74 73 71 69 68 70 73 75 77 78 80 82 83 84 84 83
78 77 74 72 70 68 66 65 65 67 69 72 75 78 78 77 74 70 68 69 72 75 78 80 82 84 86 87 88 88
80 78 76 73 71 68 64 62 63 66 70 74 79 81 82 80 76 72 70 70 72 75 78 80 83 84 86 88 89 90
80 79 77 75 73 69 65 63 64 68 73 78 82 85 85 83 79 75 72 71 73 75 78 80 81 83 84 86 88 89
78 78 77 76 74 70 66 64 66 70 76 81 85 88 88 86 82 78 75 73 73 75 76 78 79 80 81 83 85 86
76 76 77 77 76 72 68 67 68 73 78 83 87 90 90 88 85 81 77 74 73 72 73 74 75 77 79 81 82 83
75 76 77 78 77 73 69 68 70 74 78 83 87 90 91 89 86 82 77 74 71 70 69 70 72 75 78 80 80 80
75 76 78 79 77 74 70 69 70 74 78 82 86 89 90 89 86 82 77 73 70 68 67 67 70 73 76 78 78 78
76 77 79 80 78 74 71 69 71 74 78 81 84 87 88 87 85 81 76 73 70 68 67 67 69 72 74 76 77 77
76 78 80 80 78 74 71 70 72 75 78 81 83 85 86 85 83 80 76 73 71 69 69 69 70 72 74 75 76 76
76 77 80 80 78 74 71 71 73 76 78 80 82 83 83 83 81 79 76 74 73 72 72 72 72 73 74 74 75 75
73 76 78 79 77 74 72 72 74 77 79 80 81 82 81 80 79 77 76 76 75 75 75 75 75 74 74 73 73 73
71 73 77 78 77 74 72 73 75 77 79 80 81 81 80 78 77 76 77 77 77 77 77 77 77 76 74 72 71 70
68 71 74 76 76 74 73 74 76 78 80 81 82 81 80 78 77 77 77 78 78 78 78 78 77 76 74 72 69 68
66 68 71 73 73 72 72 73 75 77 80 82 83 83 82 80 78 78 79 79 78 78 78 78 77 76 74 71 69 67
64 65 67 68 68 68 69 70 73 76 79 83 85 85 84 81 80 79 79 79 78 77 77 77 77 76 74 72 69 68
62 63 63 63 63 63 65 67 70 74 78 83 86 86 84 82 80 79 79 78 76 75 76 77 77 77 75 73 71 70
63 63 62 60 60 60 62 65 68 72 77 82 84 84 81 79 77 77 76 76 75 74 75 77 79 79 77 75 74 73
66 65 63 61 60 61 64 67 70 73 77 80 81 79 76 73 72 72 73 73 74 74 76 79 80 80 79 77 75 75
68 67 65 64 63 65 67 70 73 75 77 78 76 72 68 65 65 66 68 71 73 75 78 81 82 82 80 77 76 76
70 69 68 67 67 68 71 74 76 78 78 76 72 65 60 57 58 61 64 68 72 76 80 83 84 83 80 78 76 76
70 70 70 69 69 71 73 77 79 80 79 76 69 61 55 53 54 58 62 67 72 76 81 84 85 83 80 77 76 76
