88
81 79 75 72 69 66 64 64 68 75 82 86 87 87 87 88 87 84 80 76 74 71 69 66 64 63 65 69 74 77
83 81 78 75 72 69 67 67 70 76 81 84 85 84 84 84 82 80 77 74 73 71 69 67 65 65 67 70 74 77
85 83 80 77 74 71 69 69 72 76 80 82 81 80 79 78 76 73 72 72 72 71 70 69 68 68 69 72 75 77
85 84 82 79 76 73 71 71 73 75 77 78 78 76 74 71 68 66 67 69 71 72 71 70 69 69 70 71 72 73
84 83 81 78 76 73 72 71 72 74 76 76 76 74 71 67 63 62 64 68 72 73 73 72 71 70 69 69 68 68
80 80 78 77 74 73 72 72 73 74 75 76 76 74 70 65 60 59 63 68 72 74 75 73 71 69 67 66 64 63
76 76 76 75 73 72 72 73 74 74 75 76 76 74 70 65 60 59 62 67 72 74 75 73 71 68 66 63 61 60
71 72 72 72 72 71 72 73 74 75 75 75 75 74 71 66 61 60 62 66 70 73 73 72 70 67 65 63 61 60
68 68 69 70 70 71 73 75 76 76 76 75 74 73 71 67 64 62 62 65 68 70 71 70 68 66 64 63 62 61
66 66 67 68 69 71 73 75 77 77 75 73 71 71 70 69 67 65 64 65 66 67 68 67 66 65 64 64 63 63
66 66 66 67 69 71 73 76 77 77 74 71 69 69 70 71 71 69 68 67 66 66 66 65 63 63 63 64 64 63
69 68 68 68 69 70 73 75 76 75 72 69 66 67 69 72 74 73 72 70 68 66 64 62 61 61 63 64 65 65
73 72 71 70 70 70 71 72 73 72 69 66 65 67 71 75 77 78 77 74 72 68 64 61 60 61 63 65 66 66
78 77 75 72 70 69 69 69 70 69 68 66 67 69 73 77 79 80 79 78 75 71 66 62 61 62 65 67 68 69
82 80 78 75 72 69 68 67 67 67 68 69 71 74 77 80 81 81 81 80 78 74 69 65 64 65 67 69 70 70
83 82 80 77 74 71 69 67 67 67 68 71 75 79 81 81 80 79 80 80 79 76 71 68 66 68 70 71 71 71
83 83 82 80 77 74 71 69 68 68 70 74 78 81 82 81 79 77 77 78 78 76 73 70 68 69 71 72 72 72
81 82 82 81 79 77 74 71 70 70 71 75 78 81 81 80 78 76 76 77 78 77 75 72 70 70 71 72 73 73
79 79 80 81 80 78 76 73 72 71 73 75 78 80 80 79 77 75 75 76 78 78 77 75 73 72 72 72 73 73
76 76 77 78 78 77 75 74 73 74 74 75 77 79 79 79 78 76 76 77 78 80 80 79 77 75 73 72 72 72
73 73 73 74 74 74 73 73 75 76 77 77 78 79 80 79 78 77 76 77 79 81 82 82 81 78 75 71 69 67
72 72 71 71 71 70 71 73 76 79 79 79 78 78 78 78 77 76 76 77 80 82 83 84 84 81 77 71 66 63
72 72 71 69 69 68 70 72 77 80 81 80 78 77 76 75 74 74 75 77 80 82 85 86 85 82 77 71 65 61
72 71 70 69 68 67 69 72 76 79 81 80 79 77 75 73 72 72 73 76 79 83 85 85 84 81 77 71 66 63
70 69 68 68 67 68 69 71 74 78 80 80 79 78 75 73 71 71 72 75 79 83 85 84 81 78 75 72 69 67
66 66 66 66 67 67 68 70 72 75 78 80 81 80 77 74 72 72 73 76 79 82 83 81 78 74 72 71 71 70
62 62 63 64 65 66 67 68 70 74 77 80 82 80 78 74 73 73 74 76 78 81 81 79 74 71 70 70 71 71
57 58 59 61 63 65 66 67 69 73 77 80 81 80 76 73 71 72 73 74 75 77 77 76 72 69 69 70 70 71
54 55 57 60 62 64 65 67 69 73 77 79 79 77 73 69 68 69 70 70 71 72 73 73 71 70 70 70 70 70
52 54 56 59 62 64 65 67 69 73 76 78 78 75 70 67 66 67 67 67 67 68 70 70 70 70 71 71 70 69
