91, 91
73 75 77 80 80 77 71 65 62 62 63 62 60 60 61 63 66 71 76 82 85 87 85 81 76 70 67 68 70 72
69 71 74 77 78 76 72 67 64 63 64 63 62 62 63 64 67 71 76 81 84 84 83 80 75 71 69 70 73 75
63 66 69 73 76 76 73 70 67 66 66 66 66 66 66 67 69 72 76 80 81 81 80 78 75 72 71 73 77 80
60 63 67 71 74 76 75 73 71 69 69 69 69 69 69 70 72 75 77 79 78 77 77 76 74 73 74 77 82 85
63 65 68 72 75 77 78 77 75 73 71 71 70 70 70 71 73 77 78 78 76 74 73 73 73 73 75 79 84 87
69 70 72 75 77 79 81 81 79 77 73 71 69 68 68 70 74 77 79 76 73 70 69 69 70 71 73 77 81 84
77 77 77 78 80 82 84 84 83 79 75 70 66 65 65 68 73 77 78 75 70 66 65 66 67 68 70 72 75 77
82 81 80 80 82 84 86 86 85 81 76 70 66 63 64 67 72 76 77 74 69 65 63 64 65 66 68 69 69 70
82 81 80 80 82 84 85 86 84 82 77 72 67 64 64 67 71 75 75 73 69 66 64 64 65 65 66 66 66 65
80 79 78 79 80 82 82 83 82 81 78 73 70 67 66 67 70 72 73 72 70 68 67 67 66 66 66 65 65 64
77 77 77 78 79 79 78 78 79 79 78 76 73 71 69 68 68 69 71 72 73 73 73 71 69 68 67 66 66 65
78 77 77 77 77 76 75 75 76 77 78 77 76 74 71 68 66 67 70 73 75 77 77 76 73 70 69 69 69 69
81 80 79 78 77 75 73 73 74 77 78 79 79 77 73 68 65 65 69 73 77 80 81 79 76 73 72 73 74 74
83 82 80 79 77 74 71 71 73 76 79 80 79 77 73 68 65 66 69 73 78 81 82 80 77 75 75 76 78 79
83 82 81 79 77 74 71 71 73 76 79 79 78 76 72 69 67 67 70 74 78 81 82 80 77 75 76 77 80 81
82 82 81 80 77 74 72 71 73 77 79 79 77 75 72 70 69 71 73 75 78 80 81 80 77 75 75 77 79 81
82 81 81 80 78 75 72 71 74 77 79 79 77 75 73 72 73 75 77 78 79 80 80 78 76 73 73 75 77 78
83 83 83 82 80 77 74 73 75 78 80 80 78 76 74 74 75 78 79 79 78 78 78 77 75 73 73 74 75 76
84 84 84 84 82 79 76 75 77 79 81 81 79 77 75 75 77 79 80 79 77 76 76 76 76 75 75 75 75 75
84 83 83 83 83 81 78 77 78 80 81 81 80 79 76 75 75 76 76 75 73 72 72 74 76 77 78 78 77 76
81 81 81 82 83 82 81 80 80 80 80 81 80 78 75 72 71 70 70 69 68 68 70 73 76 80 81 80 77 75
78 77 77 79 82 83 83 82 81 80 80 80 80 78 74 70 66 64 63 62 63 64 67 72 76 80 81 80 76 73
74 74 74 76 79 82 83 83 81 80 79 79 79 77 73 68 63 59 57 57 58 62 66 71 76 80 81 78 73 69
71 70 71 73 76 79 81 82 81 80 79 79 79 77 73 68 62 57 54 54 57 61 67 72 77 80 80 77 71 67
68 68 68 70 73 76 78 80 80 79 78 78 79 77 74 68 63 58 55 55 58 63 69 74 78 81 80 77 72 69
66 66 67 69 71 73 76 78 78 77 77 78 78 77 74 70 66 62 60 60 62 67 73 77 80 81 81 79 75 71
64 65 66 68 70 72 75 76 76 76 77 78 79 78 76 73 70 68 66 66 68 73 77 80 81 82 81 79 76 73
63 64 66 69 71 73 75 76 76 77 78 80 82 81 80 78 76 74 73 72 74 77 81 82 82 82 81 78 75 72
62 63 66 70 73 75 77 77 77 79 82 85 87 87 85 83 82 80 78 77 78 81 83 84 83 82 80 77 73 70
61 63 66 70 74 76 77 78 78 81 84 89 91 91 89 87 85 83 80 79 80 82 84 85 84 82 79 75 71 67
