94
94 91 84 78 74 74 75 76 76 76 76 76 74 73 73 77 84 89 88 80 69 60 55 55 58 62 66 70 73 74
90 87 82 77 74 73 74 75 75 74 74 73 72 71 72 76 82 86 85 79 70 62 59 58 60 63 67 72 76 78
84 82 78 74 72 72 73 73 72 71 70 70 70 70 70 73 78 81 82 77 71 65 62 62 63 65 68 74 79 82
78 76 73 71 70 71 71 71 69 67 67 67 68 69 70 72 74 77 77 76 72 69 67 66 65 66 69 74 81 85
71 71 69 68 69 70 71 70 68 66 66 67 68 69 70 71 72 74 75 75 74 72 70 69 68 68 70 74 81 85
65 65 66 67 69 71 72 72 70 68 68 69 70 72 72 73 73 74 76 77 76 75 74 73 71 70 71 74 79 83
59 61 63 67 71 74 76 75 73 72 72 72 73 75 75 75 75 76 78 79 80 79 77 76 74 72 72 73 76 78
55 58 61 66 71 76 79 78 77 75 75 75 77 77 78 78 79 80 81 82 82 81 79 78 76 73 72 72 73 74
56 58 62 67 72 77 80 80 78 76 76 77 78 79 80 80 81 82 83 84 83 82 80 77 75 72 70 70 70 70
63 64 66 68 72 77 80 80 78 76 76 77 79 79 80 80 81 82 82 82 81 79 77 74 71 69 68 68 68 69
71 71 71 71 73 75 78 78 77 76 76 77 78 79 79 79 79 79 79 77 76 74 72 69 67 65 66 68 70 71
77 76 75 73 73 75 76 77 76 75 75 77 78 78 77 77 77 76 75 73 71 69 67 65 64 64 67 70 74 76
79 78 76 75 74 75 76 77 76 75 75 76 77 77 76 75 75 74 72 70 67 65 64 62 63 65 69 74 78 81
75 75 75 75 75 75 76 76 76 75 74 75 76 77 76 75 73 72 70 67 65 64 63 63 65 68 74 79 82 84
72 72 73 74 75 75 75 75 74 74 74 75 76 77 76 75 73 71 68 66 65 64 64 65 68 72 77 81 84 85
71 72 72 73 73 73 72 72 72 72 73 74 76 77 77 75 73 70 67 66 66 66 67 68 71 75 80 82 83 83
73 73 73 73 72 70 69 68 68 70 72 74 76 77 77 76 73 70 67 66 67 68 70 72 75 78 81 82 81 80
74 74 73 72 70 67 64 63 64 67 71 74 76 76 77 76 74 70 68 67 69 71 73 75 77 79 81 80 78 77
73 73 73 72 70 66 63 61 62 66 70 73 75 75 75 75 74 72 70 70 71 74 76 77 79 80 80 79 77 76
69 71 72 73 71 68 64 62 62 65 69 72 74 74 75 76 76 75 74 73 74 76 78 79 80 80 79 78 77 76
67 69 73 75 74 72 68 65 64 65 68 71 72 73 74 77 79 79 78 78 78 79 79 80 81 81 80 79 79 79
68 71 75 78 78 76 73 69 66 66 68 70 71 72 75 78 82 84 83 82 81 80 81 81 82 82 80 79 79 79
71 74 78 81 83 82 78 74 71 69 69 70 71 72 74 79 84 86 87 85 83 82 82 82 83 83 81 80 79 79
75 77 81 84 86 86 83 79 75 72 72 71 71 71 73 77 82 85 86 85 84 83 83 84 84 83 81 80 80 80
77 79 82 86 88 88 85 81 78 76 74 73 71 70 71 74 77 80 81 81 81 81 83 83 83 81 80 80 81 82
76 78 81 85 88 88 85 82 79 78 77 75 72 69 69 70 72 74 74 75 76 78 81 82 81 79 78 80 83 85
73 75 78 82 86 86 85 82 80 79 78 76 72 69 67 68 69 69 69 68 70 74 78 79 78 76 76 79 84 87
72 73 75 79 83 85 84 82 81 80 79 76 72 68 66 67 67 67 66 65 67 72 75 76 74 73 74 78 85 89
72 72 74 77 81 84 84 84 83 82 80 76 71 66 65 66 67 67 65 65 67 71 74 74 72 70 72 78 85 91
72 72 73 75 80 83 85 85 84 83 80 75 70 65 64 65 67 67 65 65 67 71 74 74 71 69 71 77 86 91
