94, 94
62 61 61 61 63 67 71 75 78 79 79 80 81 81 82 83 85 86 87 86 83 80 79 80 81 80 76 70 64 61
65 64 63 63 64 67 71 75 78 79 80 80 80 81 81 82 83 85 86 85 83 81 80 81 82 81 77 72 66 63
70 68 67 66 66 68 71 75 78 80 80 79 79 79 79 79 81 82 84 84 83 82 82 83 84 83 79 75 70 67
75 73 71 70 69 70 72 75 78 79 79 78 76 76 76 77 78 80 82 83 84 84 86 87 88 87 84 80 75 73
80 78 75 73 72 72 73 75 77 78 77 75 73 73 73 74 75 77 78 80 82 85 88 91 92 91 89 84 80 78
84 82 79 76 75 74 74 75 76 77 76 73 72 70 70 71 71 72 73 75 78 83 87 92 94 94 91 87 83 80
84 82 79 77 76 75 75 76 76 76 75 73 71 70 68 68 67 67 67 68 72 77 83 89 92 93 91 88 84 81
81 80 77 76 76 76 76 77 78 78 77 75 73 71 69 67 65 63 62 63 66 72 78 84 88 90 89 86 82 80
75 74 73 73 74 76 78 79 81 81 80 77 75 73 70 68 66 63 62 62 64 69 75 81 84 86 85 83 80 79
71 70 70 70 72 75 78 80 82 83 81 78 76 74 72 70 68 66 65 65 67 70 75 79 81 82 81 80 79 78
71 70 70 70 72 75 78 81 83 82 80 77 75 75 74 73 72 71 70 71 72 74 76 78 79 79 78 77 77 77
74 73 73 73 75 78 80 82 82 80 77 74 73 73 74 74 74 74 75 76 77 77 77 77 76 75 74 74 75 75
78 78 77 78 79 81 83 83 81 78 74 71 70 71 73 74 75 76 78 80 81 79 77 74 72 70 70 70 71 72
79 79 79 80 81 83 85 84 82 77 72 68 68 70 71 73 74 76 80 83 83 81 76 71 68 66 66 67 68 68
78 79 79 80 82 84 85 85 82 78 72 69 68 69 70 71 73 76 81 84 85 82 76 70 66 64 65 65 66 65
76 77 77 78 80 82 84 84 82 79 74 71 69 70 70 71 73 77 82 85 86 83 77 71 67 65 65 66 65 65
72 73 75 77 79 81 82 83 82 79 76 73 71 70 71 72 74 78 82 86 86 84 80 75 71 69 69 69 69 68
67 69 72 75 79 81 81 81 80 78 76 74 71 71 71 73 75 79 83 85 86 84 82 79 77 75 74 74 73 72
59 62 68 74 79 81 81 79 78 77 75 73 72 71 72 74 77 80 83 84 85 84 83 82 81 81 80 79 78 77
53 57 64 72 78 81 80 78 76 75 74 72 71 71 73 76 79 81 84 85 85 85 84 84 84 84 83 83 81 81
51 55 62 70 76 79 78 76 73 72 72 71 71 72 74 77 80 83 85 85 85 84 84 83 83 83 84 83 83 82
52 55 61 68 73 76 75 73 70 70 70 71 72 73 75 78 81 83 84 85 84 84 83 82 82 82 82 82 82 81
55 58 62 67 71 72 71 69 68 67 68 70 72 74 76 78 80 82 83 83 83 82 81 80 80 80 80 80 79 78
62 63 66 69 71 71 69 67 66 67 68 70 72 73 75 76 77 78 78 78 78 78 78 77 78 78 78 77 75 74
72 72 72 73 74 73 70 68 67 67 68 70 71 72 73 73 73 73 72 71 71 72 73 73 74 76 76 74 72 70
81 80 79 78 77 75 73 71 69 68 69 69 70 70 70 70 69 67 65 63 64 65 67 69 71 73 75 74 71 69
87 85 83 81 79 77 76 73 71 70 68 68 67 67 67 67 66 63 59 58 59 61 63 65 68 72 75 75 73 70
89 87 83 80 77 76 75 74 72 70 68 66 65 65 66 66 64 61 57 56 57 59 61 63 66 71 75 76 74 72
90 87 82 77 74 73 73 73 72 71 68 65 63 63 63 64 63 60 57 56 57 60 61 63 66 70 75 77 76 74
90 86 81 75 71 70 70 72 72 71 68 65 62 61 62 63 62 59 57 56 58 60 61 62 65 70 74 77 76 75
